########################++~~~~~~~~~~~~~~~~~~~~~~~~~~~~~~~
########################++~~~~~~~~~~~~~~~~~~~~~~~~~~~~~~~
########################++~~~~~~~~~~~~~~~~~~~~~~~~~~~~~~~
########################++~~~~~~~~~~~~~~~~~~~~~~~~~~~~~~~
########################++~~~~~~~~~~~~~~~~~~~~~~~~~~~~~~~
########################++~~~~~~~~~~~~~~~~~~~~~~~~~~~~~~~       ppp     ppp
########################++~~~~~~~~~~~~~~~~~~~~~~~~~~~~~~~       ppp     ppp
########################++~~~~~~~~~~~~~~~~~~~~~~~~~~~~~~~
########################++~~~~~~~~~~~~~~~~~~~~~~~~~~~~~~~
++++++++++++++++++++++++++~~~~~~~~~~~~~~~~~~~~~~~~~~~~~~~
++++++++++++++++++++++++++~~~~~~~~~~~~~~~~~~~~~~~~~~~~~~~
#########################+~~~~~~~~~~~~~~~~~~~~~~~~~~~~~~~
#########################+~~~~~~~~~~~~~~~~~~~~~~~~~~~~~~~
########################++~~~~~~~~~~~~~~~~~~~~~~~~~~~~~~~
########################+~~~~~~~~~~~~~~~~~~~~~~~~~~~~~~~~
########################+~~~~~~~~~~~~~~~~~~~~~~~~~~~~~~~~
########################+~~~~~~~~~~~~~~~~~~~~~~~~~~~~~~~~
########################+~~~~~~~~~~~~~~~~~~~~~~~~~~~~~~~~
########################+~~~~~~~~~~~~~~~~~~~~~~~~~~~~~~~~
#